20
15
4 4 4 4 4 4 4 9 4 4 4 4 4 4 4 4 4 4 4 4
4 4 4 4 4 4 4 9 9 9 9 4 4 4 4 4 4 4 4 4
4 4 4 4 4 4 4 9 4 4 4 4 4 4 4 4 4 4 4 4
4 4 4 4 4 4 4 9 4 4 4 4 4 4 4 4 4 4 4 4
4 4 4 4 4 4 4 9 4 4 4 4 4 4 4 4 4 4 4 4
4 4 4 4 4 4 4 9 4 4 4 4 4 4 4 4 4 4 4 4
4 4 4 0 1 4 4 9 4 4 4 4 4 4 4 4 4 4 4 4
4 4 4 2 3 4 4 9 4 4 4 4 4 4 4 4 4 4 4 4
9 9 7 8 9 9 9 9 4 4 4 4 4 4 4 4 4 4 4 4
4 4 4 4 4 4 4 9 4 4 4 4 4 4 4 4 4 4 4 4
4 4 4 4 4 4 4 9 9 7 8 9 9 9 9 9 9 9 9 9
4 4 4 4 4 4 4 9 4 4 4 4 4 4 4 4 4 4 4 4
4 4 4 4 4 4 4 9 4 4 4 4 4 4 4 4 4 4 4 4
4 4 4 4 4 4 4 9 4 4 4 0 1 4 4 4 4 4 4 4
4 4 4 4 4 4 4 9 4 4 4 2 3 4 4 4 4 4 4 4